0  0  0  96 96 96 96 96 96 0  0  0
0  0  0  96 96 96 0  96 96 0  0  0
96 96 96 96 96 96 96 96 96 0  0  0
96 96 96 0  96 96 96 96 96 0  0  0
96 96 96 96 96 96 96 96 96 0  0  0
96 96 96 96 96 96 96 96 96 0  0  0
96 96 96 96 96 0  96 96 96 0  0  0
0  0  0  96 96 96 96 96 96 0  0  0
0  0  0  96 96 96 96 96 0  0  0  0